+---+-----------+
|   | c         |
|   |      |    |
|   ========    |
|               |
|               |
|               |
=====+   +=======
xxxxx|   |
xxxxx|   |
+=====   =======+
|               |
|               |
|   ========    |
|   |      |    |
|   |      |    |
|               |
=================
